###########################################
#               #                         #
# ############# # #### ################## #
#                    #                    #
# # ################## ##### # ########## #
A #               @          #            B
# # ######################## # ######## # #
# #                                     # #
# # #### # ############################ # #
#        #             M                  #
###########################################
